F   24 ,   27   ,0
C   0 , 60 , 255    
NO /Users/wkonings/wkonings/cub3d/assets/redbrick copy.png
SO /Users/wkonings/wkonings/cub3d/assets/greystone.png
EA /Users/wkonings/wkonings/cub3d/assets/mossy.png
WE /Users/wkonings/wkonings/cub3d/assets/bluestone.png



        1111111111111111111111111111
       11 1000000000110000000000001111111
      111111101100000111000001110000111111
      11110010000000000000110000111111
1111111	111111111011000001110000011100001111
1000000000110000011101111111111111111111
11110111111111011100000010001
11110111111111011101010010001
11000000110101011100000010001
10000000000000000000000000001
10000000000000001101010010001
11000001110101011111011010N0111
11110111 1110101 101111010001
11111111 1111111 111111111111