

1111111111111111111
1000000000000000001
1000000000000001111
1000000000000000001
1000000000000001111
1000000100000000001
1000001N10000001111
1000000000000000001
1000000000000001111
1000000000000000001
1000000000000001111
1000000000000000001
1000000000000001111
1000000000000000001
1000000000000001111
1000000000000000001
1000000000000001111
1000000000000000001
1000000000000001111
1000000000000000001
1111111111111111111




