F   24 ,   27   ,0
C   0 , 60 , 255    
NO   /Users/wkonings/wkonings/cub3d/assets/redbrick.png
SO /Users/wkonings/wkonings/cub3d/assets/greystone.png
EA /Users/wkonings/wkonings/cub3d/assets/mossy.png
WE /Users/wkonings/wkonings/cub3d/assets/bluestone.png



        1111111111111111111111111
        1000000000110000000000001
        1011000001110000011100001
        10010000000000001 1000011
111111111011000001110000011100001
100000000011000001110111111111111
11110111111111011100000010001
11110111111111011101010010001
11000000110101011100000010001
100000000000000000000000N0001
10000000000000001101010010001
1100000111010101111101101000111           111
11110111 1110101 101111010001             111
11111111 1111111 111111111111111111 111111111















